+---+---+---+---+---+---+--- ---+---+---+---+--- --- --- --- ---+
|                                                               |
+   +---+---+---+---+---+   +   +---+---+---+   +   +   +   +   +
|       |               |   |       |       |   |   |   |   |   |
+   +   +   +   +---+---+   +   +   +   +   +---+---+   +   +   +
|   |   |   |           |       |       |                   |   |
+   +   +   +---+---+   +   +   +   +---+   +   +---+   +   +   +
|   |   |           |   |   |       |       |           |   |   |
+   +   +---+   +---+   +   +   +---+   +---+   +   +---+   +   +
|   |       |   |       |               |       |   |       |   |
+   +   +---+   +---+   +---+---+---+---+   +   +   +   +---+   +
|           |       |   |                   |   |       |       |
+---+   +---+---+   +---+   +---+---+   +   +   +   +---+   +   +
|                   |                   |           |       |   |
+---+   +---+---+---+   +---+---+---+   +---    +   +---+   +---+
|           |   |   |       |       |   |       |   |           |
+---+   +---+   +   +   +   +   +   +---+   +   +---+---+---+   +
|           |   |   |   |   |       |       |   |       |       |
+---+   +---+   +   +   +   +   +---+   +   +---+   +   +   +   +
|   |       |   |   |           |       |   |       |       |   |
+   +---+   +   +   +---+   +---+   +   +---+   +   +---+---+   +
|   |           |       |           |   |       |   |           |
+   +---+---+   +   +   +---+---+---+---+   +   +---+---+---+   +
|   |       |       |   |   |   |       |   |   |               |
+   +   +---+---    +   +   +   +   +   +   +   +   +   +---+   +
|   |       |       |       |   |   |       |       |   |       |
+   +   +---+   +   +---+   +   +   +---+---+   +   +---+---+   +
|       |       |   |   |       |   |   |       |       |       |
+    ---+   +---+   +   +   +---+   +   +   +---+---+   +---+   +
|               |   |   |   |       |   |       |               |
+   +   +---+---+   +   +   +   +---+   +---+   +   +---+   +---+
|   |                                                           |
+---+---+---+---+--- --- --- ---+---+---+---+--- ---+---+---+---+
