+---+---+---+---+---+---+---+---+---+---+---+--- ---+---+--- ---+
|   |                                       |                   |
+   +   +---+---+---+---+---+   +---+---+   +   +   +---+   +   +
|   |   |       |           |           |   |   |       |   |   |
+   +   +   +   +   +   +   +---+   +   +   +   +---+   +   +   +
|   |   |   |       |   |       |   |   |   |       |   |   |   |
+   +   +   +---+---+   +   +   +   +   +   +---+   +   +   +---+
|   |   |       |       |   |       |   |               |       |
+   +   +   +   +   +---+   +---+---+   +   +---+---+---+---+   +
|           |   |       |           |                           |
+   +---+---+   +---+   +---+---+   +---+---+---+---+---+---+   +
|           |                   |               |           |   |
+---+---+   +---+---+---+   +   +---+---+---+   +---+---+   +   +
|           |               |               |   |           |   |
+   +---+---+   +---+   +---+---+---+   +   +   +   +---+---+   +
|   |       |       |       |           |   |   |               |
+   +   +   +   +   +---+   +   +   +---+   +   +   +---+---+---+
|   |   |       |   |       |       |       |   |               |
+   +   +--- ---+   +   +---+---+---+   +---+   +---+---+   +   +
|   |   |       |   |   |           |       |   |           |   |
+   +   +   +   +   +   +   +---+   +---+   +   +   +---+---+   +
|   |       |       |       |           |       |               |
+   +   +---+   +---+---+---+   +---+   +   +   +   +---+---+---+
|       |       |                   |       |   |               |
+   +---+   +---+   +---+---+---+   +---+---+   +---+---+   +   +
|           |       |           |           |               |   |
+   +---+---+   +---+   +---+   +---+---+   +---+---+---+---+   +
|   |       |   |       |   |   |       |   |               |   |
+   +   +   +   +   +---+   +   +   +   +   +   +---+---+   +   +
|       |       |   |               |   |   |   |       |   |   |
+---+   +---+---+   +   +---+---+---+---+   +   +   +---+   +   +
|                                               |               |
+---+---+---+---+--- ---+---+---+---+---+--- ---+---+---+--- ---+
