+---+---+---+---+---+---+---+---+---+---+---+---+---+---+---+---+
|           |           |                                       |
+   +---+   +   +---+   +   +---+---+---+---+---+---+---+---+   +
|   |       |   |       |                                       |
+   +   +---+   +   +---+   +---+---+---+   +---+---+---+---+   +
|   |       |   |                       |                   |   |
+   +---+   +   +   +---+---+---+---+---+---+   +---+---+   +   +
|   |       |   |   |               |           |           |   |
+   +   +---+   +   +   +---+---+   +   +   +---+   +---+---+   +
|   |           |   |   |               |   |               |   |
+   +---+---+---+   +   +   +---+---+   +   +---+---+---+   +   +
|               |   |   |   |       |       |               |   |
+---+---+---+   +---+   +   +   +---+---+---+   +---+---+---+   +
|           |   |       |   |               |           |   |   |
+   +---+---+   +   +---+---+---+---+---+   +---+---+   +   +   +
|   |       |   |           |       |   |               |   |   |
+   +   +   +   +---+   +---+   +   +   +---+---+---+---+   +   +
|   |   |   |   |       |           |           |           |   |
+   +   +   +   +   +---+   +--- ---+---+   +---+   +   +   +   +
|   |   |   |   |   |       |           |       |   |   |   |   |
+   +   +   +   +   +   +---+   +   +   +---+   +   +---+   +   +
|   |       |   |   |   |       |   |       |               |   |
+   +   +   +   +   +   +   +---+   +---+   +---+   +---+   +   +
|       |   |   |   |   |   |           |       |       |   |   |
+   +   +   +   +   +   +   +   +---+   +---+   +---+   +   +   +
|   |   |   |   |   |   |   |   |           |       |       |   |
+---+   +   +   +   +   +   +   +---+---+   +---+   +---+   +   +
|       |       |       |   |                   |       |   |   |
+   +   +---+---+---+---+---+   +---+---+---+   +---+   +   +   +
|   |                                           |           |   |
+   +   +---+---+---+---+---+   +---+---+---+---+---+---+---+   +
|   |                                                           |
+---+---+---+---+---+---+---+---+---+---+---+---+---+---+---+---+
